########################################
#                                      #
#                                      #
#                                      #
#                                      #
################        ################
#                       #              #
#                       #              #
#                       #              #
#                       #              #
#                       #              #
#                       #              #
#         ###############              #
#         #                            #
#         #                            #
#         #                            #
#                                      #
#                                      #
#                                      #
########################################